%%%%%%%%%%%%%%%
%.      %    S%
% %%%% %%% %  %
% %G  % %S  % %
%   %% %% %%  %
% % G     % % %
%% % %% %%%%  %
% %Ggggggggg% %
%   %%% % %%% %
% %  S% %     %
% %%%     %% %%
%S  % % % %   %
%%%%%  %% G % %
%     %   % %P%
%%%%%%%%%%%%%%%
