%%%%%%%%%%%%%%%%%%%%%%
% %%        %S%      %
%    %%%%%% % %%%%%% %
%%%%%%     P S%      %
%    % %%%%%% %% %%%%%
% %%%% %gGggggggg%   %
%        %%%S%%%   % %
%%%%%%%%%%  S %%%%%% %
%.         %%        %
%%%%%%%%%%%%%%%%%%%%%%